type octile 
height 49
width 49
map
1222322323554321122223445421222223233345654334531
2333323324444222243234533222321211111234544344441
3446544324444233352233444344432333243455644455431
4468654334443233353233444333221122243343322244321
5578543235444355442133343344332122243331101344311
4466431124455566543144453344332122254552211332201
4465431125577676544255452222211001133331111222223
43433433244799A7533377664311111112244441222433323
3233454324477675433477764301222212233442322322212
4344454323355564312466542323543312333321322312212
3233354432233443201356642223543311223432433412212
4232233333222223212345532224665310124543322312212
5232122332101345533446532123454431225543233533312
3121133442101234432335532112233331114554222433323
2231122332101234433434423323234552113454221332223
2331122332100124665544423322112553312333221232232
3332122332100002344333323434311111222332321222221
2232223434222112345544423324434532322332321222232
5423224445332123464554421113435644334443321222232
6535445444332122343345542113445544434443321222211
3435667554453222454444442111245655534333211233211
2435555453431122464444565332133455555333222233211
2433555653421111343323566443242343443223334355332
3332445654433332343311345444343233233235557555222
3222335655312232232222444334343232122358988544211
4323568754212233232121332212234332001247989755211
5414568554222233243231333324345332001346989843101
5324577565432123244342333323344321001345766632101
3344586465553124356442223323445422001233444421012
1243353255675322135443335434444311001234554321122
1022242244565322125455344322334312101135675321111
1231121233443212235344344323334323323345786432231
1220000122443311234344355434333133444434799753341
1110111223432123345565232334445453455544688642352
1100112334433245455655222223445554687644577542242
1011222223333233357876223455554454664323578642012
3243332323223354456765212355553554543224566321012
3243221222112343334445334355443555532113455321001
3366663321222321112244344466455664200123433211012
3356665432222432311123344344234443101245431112234
2124556432111211211124456444124333113355320112223
4346778542111211212334345454345433113355321224323
5555435443100111213546435343223323113355332445423
5666435443212222112447545243333324223233222344333
5777535444323333212446544232344544322333322355443
4566435566545544222345433122122334444554432464421
3334335455445544221243432134321224544432211243321
3443433455543323233232541112221334533433422332221
2233443454543322133222321111111112233333433432211
