type octile 
height 49
width 49
map
1111111111113322111111122221111112334322122111111
1221100111212212222233212232110112323322100000011
2211101222212212221222112232101223223322100000011
2111102444311100112322112233222234432211100000012
1111102444311101223322101123223344210111100000012
1000113433100001222100000012334455320000000111101
1000223422211101222100000012333344320000000222201
2110222200111101111000001111222222110000000222201
2110222200111100000000011111221122220001111222201
2110122210111100011221111111110011110112211111101
2110011221100000011221100011111122221212211000001
1000011221100000022331100000001122221212211000001
1000011221100000022331100000001111111211100011111
1000000111100000011110011110001111111100000022221
1000000000000000011111122110000000000001111022221
1110000000000001111001122110000111100002222022231
1121110000000001111001122110000221100002222011121
1121110000000012111001222100000221100002222000011
1111110000000012110000111100000111000001111000011
1111110011110000000000111100000000000000000000001
1100000011110000000000111100001122110011110000001
1100000011110001111000000000001122221111221100001
1100000011110001112111000000001122221111221100001
1000000000000001112112111000012232221111221100001
1000000000000001112224322000011111222100111100001
1000000000012221001224322000011111111000000000001
1100001112123221000113322000022221111000000000001
1110001112123221011333311000011111111000001122111
1110001112123221011232222221011110000000001122111
1110001112112111011232222221011110000000001122111
1111101111001111011232222221000000111100001122111
1221101111001112111011133331000111211211111110011
1221101111001112111000011110111211211211111110011
1221101111000001111000011110111211211211111110011
1100000000000112210000011110111211000111111110011
1000001111001222211211211101222100000000000000001
1000001111001233321211211101111000001111001111001
2110001111001233322433311101111000002222001111001
3110001111001122222433311101111011223322001112112
3110000001111011111233210000000011223322001112112
2110000001122110001233210000000011233321000012222
1000000001233210000011110000000011232210000012222
1000000002345321000011110000111100011110000012222
1011110123444321000000000000111100011110000012222
1011110123433211000000000000111100000000111212212
1011110123322111000000000110111100001111111212212
1011110122210000000011100121100000001111111211101
1110000000000001111011110011121122101221111211111
1111111111111111111111111111122122112332111111111
