type octile 
height 49
width 49
map
1122123334311111111221111111222211111221221122232
2110000111100112211121100023333322100000000011121
2211211211100223421100000023322222000000122221121
1111222211111222311100000012222111011111244320001
1111223322111233421211100012222111011111244320001
1122344432111122321322200001111000012222355420012
2122133443211012221222211001123232133332233210012
2123233343210012222333223212223232122332211111111
2123233343210001112222232212223232123443211111111
2113223233210001112111133432112232122333211122211
1002223133220001112111012343210000001223212233211
1002334334432101111000123332110000001112112222101
2113444223432101112122233343220000000001112222101
2123443223432101112122221122220000111100112322101
2123454322434311001133331111110001211100111211101
2233343110223312112133220022220112322210111211122
1123354220223313212122110011110112322322322211122
2223244342433313213233110011110123432322211111111
2213233232432201112222000011110133342322222332211
2212233332321100003333111100001134443435433332201
3311111222321100002333211100001134443435433333323
2200111100111100001222211100001123222335434444334
1100122211122110001222211100001112112335423223223
1000011111122122332211100000000000111212212223223
2000011111122122332100000000000122432200001222123
2000011112233122332211100111100122433311000111112
1111110001111013443211100111212333433312111111112
1121110001111001111111100222312444422212111222212
1121110001111012221111100222312333211112111233311
1132221111000012221000000233422333210001111122211
2122332212111011110000111444410133210111101233222
2232443323221012232011221344420144210111101122132
1243543434321001122011221344420122100111101111011
1232443433321001111022331222210112211111101222111
2333432332210001110144430022220112111000000222211
2233321333311001111133320011110001111011110222201
1123332223322001233343320011110012221022220222201
1123321113322112333332210012221122210033341222212
1001111113322112333321101112111123321033341111112
1012221001111122332321101112111123321022342222222
1133431100000245531111112222111234421022342222222
1133431211100134431111113332000123333232332211111
1133431211211345642100012221000233322232332211111
1122432311211445644332122332100233444442233321001
1000111211211322323332111222100111245553344321001
1000111100111322323332110111211211233333344232111
1000111100000111222243210133421100133333344232111
1110000000000001221132110022332311111123332023331
1111111111111111111232111111223311111112222134431
