type octile 
height 49
width 49
map
4556786454575344456777543244333234344332123454211
2355696464564345566566653355432588775321245653222
11356A7697997544355777875555534677787544466664343
1024475476888754346899A96633445566888645567876422
2124465475777754346778998744567888BAB9799A9875432
433555547687776545787877864445676697987A998677553
444665536455577666886645876656676686888BBBB987432
356775558775445577773322776877775575678BBCA776454
5676544687867899A9763224788A8765335566789BA988566
55755558888688889865334688798887666676777AAA87445
779654587887AA98976645667877678988888565598998644
8896445776679BB9966668887776677AABBA9676699ABA765
68A8767877678876656667788876668AACA87456689898565
6898756765689A86557899889988878869887466788787443
5778977766787666456687677789977548888555568787442
4898B87856766446356575678A9A967648767455557665231
3775965646888665266686889A99866648988565445576352
4777A86545776433375463578AB9765557778677678787463
3567A9786677875445356588ABBA886777566687877667453
355677676688AA8656587577ABDB996654466675789988554
4678776766658876565776889ACCCB874225788579AA87554
556778898988AA97655777888ABCECA954456763567886542
5567666678777888887787798ABACAA966689863467986532
22678988898877666676877A9BBACAA967789753355787753
1267AB9988898999A89776599CCACABA78667543234688753
2377986888876889B9975559BCDBBA9766688643234579875
2576997976778AA9A78866589BCAA86445676422124489774
1797A88976678ABAC987565889BA998577897634446467564
2777967765678BA8A767576777A9786588BC9844668667565
3545878853457997865778775687776567AA8855779987433
3334667875767865664666655588787765788976778976533
2343454554778855543667856677766954656765556765432
2243475764655434355788A78888755733435676443454332
5675454676766657566667968789865766546787443355453
6777676777876536654446878778877887434677655466463
6787677897875645544346787566778877656777666687553
56655678A8A9674653412435545677A9887668667789A8653
5556799885996624434123355655658767676644778997642
5554567775787867656344455766856646688755789AA8731
5444456776888868679665556867978867799976879998631
6556445666768878689775776867BAAA7767765677A999632
434433467988AAA979A997997868BBBB988777566699A9643
4234455666678887699897AA7858ABCAA9AA8745669898543
3234566655467676798775997969AAA898986546789999743
33557988766876768A8764776746778789A98656666667654
4456898754565344686652566745656556777545667646444
5456776544554222465543545544535534434334444424444
4466676444433334565322344332223533334222112212254
1234444223223333322211245432111221233222223322122
