type octile 
height 49
width 49
map
66798999AA98877667789A777665876666689ABBAAAAB9862
899877789A99979AAA88ABA988A9B98AAA99ABCCCBBBBA983
9ABCBBBCDEDDCABBCCAAABBDCBDCDABCBCBDDDEEFFFFFEB94
9ADECBCCDDABAACBCCBBCDDDCBCDEDDCCDDEDDEDEEEFFEA74
8ADECABABCACCCEEEFCBCCEEEEFGGFFFFGGFEDDDEDDEEFB96
79DFFDDBCCABABDEEFDCDDDCCCEFFEEFFGFEDCDDEEEFFFB96
89DFFCC99A8ABCEFEFDDEDCABBDFFFFGGGFEEDEEEEDEEEB96
89DEGCCA9CABCCEFFGFFFDCBDDCEEEFGGGFEEDDEEEEEEFCA7
9AEEGDDCBDBBCDFGGGGGGEDDDDCEEEEFFFFFFEDDDEFFFFCA7
ABFFGEECACBDEEEEFFGGGEDCCDCFFFFFEEFFGFDDDEEEDDB97
ABFFGFFEDEDEEEEEFFGFFECBBBCEEEEEDEFFFFDDEEFFEEB86
9AEFGGGFEEEFFFDDEEGFFFEEECDDDEDDCDEFFFDDEEFFEEB86
89CEFEFEDEEFFFDDEEGFFFEDDBCDDEEECDDEFFEDEEEFEEB97
57ADFEFFEEEEFFDCBCEEFFEEECDDDDCB9BBDDDDCEDEFFFB85
468CFEFFEEEEFECB9BDEGGGFEDDDEDBA899ACDDDDCDEFEB84
589BEDEEDDEEFDCC9CDCFFFFEEEFGDAA8AA8ABCDEDDEFDBA4
59BCFFFFEDEEFCA96ACCFFFGFFFFFB8659A89AADEDDDEB983
7ABDFFFEEEFGGDCCACDDFFFGFFFFFCBA9BCABCBEDDDDFB983
8AAEFEEDDEEFFDCCBCDEFFFGGGGGFCBBBDDDDDBDDDDDEBA94
89BFFFFEEFEFFEDCCDFFFFFGGGGGECBACEEEEDCDBCBBDBA85
89BFFFFEDECDDDEEFFGFFFFGFFFFFEEEEEDDEEDDBCCCEDB96
ABCFFFEEDEDDDDEEFFGEDDDFFFFFFEEDDDCDEEDDCCCCDDB85
ABDFFGEDCBBCCDFFGFECBCDFFFFFFFFEEDCDEEDDCBCCDEB85
9ADEFFDCBABCCDFFGFECBBCEEFFFGGGFEDDEEFDDECEEDEA86
9ADEFECBBBDEDEEDECBA9ACEEFFFGGGFFFFGFFEDEBCDCEA86
89ACECCBBCCDCDEDECBBBBDDCEEFGGGGGGGFEECCDBDEDFB97
7A9BECDDDFFFEEEDEDDDDBBBADEFGGGGGGGECCBCEDDEDEB86
6AABECEEDFEEDDDCEDCDDCDCBDEFFFFEFFFEDDCDEDDDCDA86
6AABEDFFEFDDDDEDEDDEECCBBEEFEEFEFEEDBCBCEEEEDDA97
589BEDEDBBBCDDCAAABDEDDCCEEFEDDBBBCCAAABEFEEDC986
689BDCCBAABCDCB989ACEEFEDEDEECCA999AABCCEFFFEC985
7BCCEDCBBBCDECBA79BCFEEDCDCCDBBC9AA9ABCCEFFGGDA94
69ABDDCBBBDEFCA96ABCFEFEDDDDEB886999BBDEFGGGGC983
78ACDEDDEFGFEBAA9BBDFEFFDDDCEC9A999ACDFFFGGGFC984
88ADEEDDDFGFECBBBCBEFEFFEEEDEDBCBBBDEEFFFGGGFD985
88BDDDDDDFGFEDCBCDDFFEEDCCDEFFDCCCDDDDDEEEFFEEA75
9ADEDCCCDFGFDDDDEDDEFFEDBBCDFGFFFEFEEEDEDDEEEFB86
ABEEDDDDEFGGFEEEEEEEFFEDCCCDEFGGGGGFFFEFEDDCDEB96
9BEEDEFFGGGGFDDDCDDDEEDCCBBCDFGGGGGFFFEFEDDCDEB96
ABEEDEFFGFFFEDDDCDDDEFFFFEDDEFGGGGGGGGFFEEEDEEBA7
AADDEFGFFEEFFEEDCEEFEEEEGEDDCEFFFFFFGGFFFEDBBCAA7
AACCDEFEECDEEFFEDEDDCCDEGEEEDEEDDDDEFGFFFDCAACA96
88ABCEFDDAACCFGFFEDDCCDEFFFFEEEDCCBBCDDEFCA779874
87ABCFFCC99CCFGFFEDDCCDEFFFFEEEDCCAAAACDFDA778774
A8BCBEEBC99CCFGGGFDBAABDDDDDEEFECCA999BDFECA99775
86ABBDDBCA9BBDDDCCBAAAABBBBABCDDABA998ACFFEDCA764
8798899898899AABAB98AAA988A9A9AA8A988789BCCCB9764
777677668778888A887676786665877979977789AAAA98774
3223554565555544223443455532433434565566777776542
